0000000000000000
0033000000000000
1111110000111111
0000000000000000
0000000303000000
0000111111110000
1100000000000000
0000000030030000
0300301111000300
1111110000003111
0000000003011111
0000000031111111
1111111111111111